15 8
EEEEEEEETTTTEEE
EEEEEEEETTTTEEE
TTTEEEEETEETTTT
TSTTTTTTTEEETFT
TTTEEEETTXEETTT
TTTEEEETTTEETTT
ETTVEEETEEEEEEE
EETTTTTTEEEEEEE

9,5; 3,7