15 10
EEEEEEEEEEETTTT
ETTTTVVTHTTTTST
ETTTTEEEEEEETTT
ETTHTEEEEEEEEEE
ETTTTEEEEEEEEEE
EEETTTHTVVTTTEE
EEEEEEEEEETTTTH
TTTEEEEEEETTTTT
TFTTTVVTTTTTTEE
TTTTEEEEEEEEEEE

8,2; 5,2; 6,2
3,4; O; 5,9; 6,9; 8,6; 9,6
6,6; C; 5,9; 6,9
14,7; 5,9; 6,9; 8,6; 9,6


