17 8
000000EEEEEEEEEEE
EEEEEEETTTTEETTTE
ETTTTEETTXTEETFTE
ETTHTEETTTTEETTTE
ETTTTEETTTTEETTTE
ETSTTVVTTTTVVTTTE
ETTTTEETTTTEEEEEE
EEEEEEEEEEEE00000

3,4; 5,6; 6,6
9,3; 11,6; 12,6


