15 10
TTTEEEEETTTTTT
TFTVVTVVTSTTDT
TTTEEEEETTTTVE
EEEEEEEEETTTVE
EEEEEEEEEEETTE
EEEEEEEEEEEETE
EEEEEEEEEEEETE
EEEEEEEEEEETTE
EEEETTTTTEETTE
EEEETHEETTTXTE

12,2; 8,2; 11,2
5,10; 3,2; 4,2
11,10; 6,2; 7,2; 12,3; 12,4
