15 10
EEEEETTTTTTEEEE
EEEEETEETTTEEEE
EEEEETEETTTTTEE
STTTTTEEEEETTTT
EEEETTTEEEETTFT
EEEETTTEEEEETTT
EEEEEETEETTEEEE
EEEEEETTTTTEEEE
EEEEEETTTTTEEEE
EEEEEEETTTEEEEE
