19 8
000000EEEEEEEEEEEEE
EEEEEEEETTTTEEETTTE
ETTTTEEETTXTEEETFTE
ETTHTEEETTTTEEETTTE
ETTTTEEETTTTEEETTTE
ETSTTVVVTTTTVVVTTTE
ETTTTEEETTTTEEEEEEE
EEEEEEEEEEEEEEEE000

3,4; 5,6; 6,6; 7,6
10,3; 12,6; 13,6; 14,6


