15 10
TTTEEEEETTTTTT
TFTVVTVVTSTTDT
TTTEEEEETTTTVE
EEEEEEEEETTTVE
EEEEEEEEEEETTE
EEEEEEEEEEEETE
EEEEEEEEEEEETE
EEEEEEEEEEETTE
EEEETTTTTEETTE
EEEETHEETTTXTE

12,2; 9,2; 13,2
10,5; 3,2; 4,2
11,10; 6,2; 7,2; 12,3; 12,4
