14 10
00000000000000
0EEEEE00000000
0ETTTEEEE00000
0ETSTTTTEEEE00
0ETTTTTTTTTEE0
0EETTTTTTTTTE0
00EEEEETTFTTE0
000000EETTTEE0
0000000EEEEE00
00000000000000

