15 10
EEEEEEEEEEETTTT
ETTTTBBTHTTTTST
ETTTTEEEEEEETTT
ETTHTEEEEEEEEEE
ETTTTEEEEEEEEEE
EEETTTHTBBTTTEE
EEEEEEEEEETTTTB
TTTEEEEEEETTTTT
TFTTTBBTTTTTTEE
TTTTEEEEEEEEEEE
