15 5
TTTTEEETEEETTTT
TSTTEEETEEETTDT
TTTTTTTTTTTTTTT
EEEEEETFTEEEEEE
EEEEEETTTEEEEEE

13,2; 12,2; 2,2