15 9
EEEEEEEEETTTEEE
EEEEEEEEETTTEEE
EEEEEEEEETTTEEE
TTTTTTEEETTTTTT
TSTTDTEEETTTTFT
TTTTTTEEETTTTTT
EEEEEEEEETTTEEE
EEEEEEEEETTTEEE
EEEEEEEEETTTEEE

4,5; 10,2; 10,8