17 7
000000EEEEEEEEE00
EEEEEEETTTTTTTE00
ETTTTEETTTEETTEEE
ETTTTTTTTTEETTTTE
ETSTTEEEEEEETTFTE
ETTTTE00000EETTTE
EEEEEE00000000000