16 11
000EEEEEEEEE0000
000EBBBBBBBE0000
EEEEBBBBBBBEEE00
ETTTTEEEEETTTE00
ETTTEE000EETTE00
ETTTEEEEEEETTEEE
ETSTEETTTTBBBBBE
ETTTEETTTTBBBBBE
EEEEEETFTEEBBTBE
00000ETTTEEBBBBE
00000EEEEEEEEEEE